7,13
11	36	0	0	0	0	0	0	0	0	0	36	11
0	0	0	0	0	0	0	0	0	11	0	0	0
0	0	0	0	0	0	0	0	11	11	0	0	0
0	0	0	0	0	0	0	11	0	11	0	0	0
0	0	0	0	0	0	0	0	11	11	0	0	0
0	0	0	0	0	0	0	0	0	11	0	0	0
11	36	0	0	0	0	0	0	0	0	0	36	11