7,13
41	0	0	0	0	0	0	0	0	0	0	0	41
0	0	0	0	0	0	11	0	0	0	0	0	0
0	0	0	0	0	37	11	37	0	0	0	0	0
0	11	11	11	11	11	0	11	11	11	11	11	0
0	0	0	0	0	37	11	37	0	0	0	0	0
0	0	0	0	0	0	11	0	0	0	0	0	0
41	0	0	0	0	0	0	0	0	0	0	0	41