7,13
11	91	11	0	0	0	0	0	0	0	11	92	11
11	11	11	0	0	0	0	0	0	0	11	11	11
0	0	0	0	0	0	11	0	0	0	0	0	0
0	0	0	0	0	11	93	11	0	0	0	0	0
0	0	0	0	0	0	11	0	0	0	0	0	0
11	11	11	0	0	0	0	0	0	0	11	11	11
11	92	11	0	0	0	0	0	0	0	11	91	11