7,13
41	0	33	0	11	0	0	0	0	0	34	0	0
0	11	11	11	0	0	0	0	0	11	11	11	0
0	0	0	0	0	0	0	0	0	0	0	0	0
0	0	0	0	0	0	0	0	0	0	0	0	0
0	0	0	0	0	0	0	0	0	0	0	0	0
0	11	11	11	0	0	0	0	0	11	11	11	0
0	0	31	0	0	0	0	0	11	0	35	0	0