7,13
11	11	0	0	0	0	0	0	0	0	0	41	41
11	0	0	0	0	0	0	0	0	0	0	0	41
0	0	0	0	11	0	32	0	11	0	0	0	0
0	0	0	0	0	32	31	32	0	0	0	0	0
0	0	0	0	11	0	32	0	11	0	0	0	0
41	0	0	0	0	0	0	0	0	0	0	0	11
41	41	0	0	0	0	0	0	0	0	0	11	11